1111111111111
10010100000C1
1000000011001
1P0010E000001
1111111111111