1111111111111111111111111111111111
1000000000000C00000000000000E01001
1010010100100000101001000000000101
1010010010101010001001000000010101
1P00000C0000000000000000C000000001
1111111111111111111111111111111111